233, 21, 0
33, 200, 23
5,16,15,15,15, 5, 5, 5, 5,19
5,16, 1,15,15,35,35,35, 5, 3
5, 0, 0, 0, 0, 0, 0, 0, 5, 5
5, 0, 0, 0, 0, 0, 0, 0, 1, 5
5, 0, 0, 0, 0, 0, 0, 0, 5, 5
5, 0, 0, 0, 0, 0, 0, 0, 5, 5
5, 0, 0, 0, 0, 0, 0, 0, 5, 5
5, 0, 0, 0, 0, 0, 0, 0, 5, 5
5, 0, 0, 0, 0, 0, 0, 0, 5, 5
5, 0, 0, 0, 0, 0, 0, 0, 5, 5
5, 0, 0, 0, 0, 0, 0, 0, 5, 5
5, 7, 6, 1, 6, 6, 6, 5, 5, 5
5, 7, 8, 0, 8, 8, 8, 8, 8, 8
8, 8, 8, 8, 8, 8, 8, 8, 8, 8