11111111111111111111111111111111
10000000100001000000000000000001
20000000100001000000000000000001
20002000100001000000000000000001
10000000100001000000000000000012
1000000021221011000000000000000021
331111111000000000000000000000001
30000000000000000000000000000001
30000000000000000000000000000001
30002201111011000000000000000001
30002000100001000000000000000001
30002000100001000000000000000001
10001000100001000000000000000001
10001000100001000000000000000001
11111111111111000000000000000001
10000000000000000000000000000001
100000000000000000000000030000001
100000000000000000000000003000001
100000000000000000000000000300001
100000000000000000000000000030001
100000000000000000000000000003001
100000000000000000000000000000301
10000000000000000000000000000001
10000000000000000000000000000001
10000000000000000000000000000001
10000000000000000000000000000001
10000000000000000000000000000001
10000000000000000000000000000001
10000000000000000000000000000001
10000000000000000000000000000001
10000000000000000000000000000001
11111111111111111111111111111111

comments here