1111111111111111111111111111111111111111111111111111111111111111
1111111111111111111111111111111111111111111111111111111111111111
1111111111111111111111111111111111111111111111111111111111111111
1111111111111111111111111111111111111111111111111111111111111111
1111111111111111111111111111111111111111111111111111111111111111
1111111111111111111111111111111111111111111111111111111111111111
1111111111111111111111111111111111111111111111111111111111111111
1111111111111111111111111111111111111111111111111111111111111111
1111111111111111111111111111100000000000111111111111111111111111
1111111111111111111111111111100000000000111111111111111111111111
1111111111111111110000000000100000000000100011111111111111111111
1111111111111111110000000000000000000000000011111111111111111111
1111111111111111110000000000100000000000100011111111111111111111
1111111111111111110001111111100000000000111111111111111111111111
1111110000000001110001111111100000000000111111111111111111111111
1111110000000001110001111111111111011111111111111111111111111111
1111110000000001000000011111111110001111111111111111111111111111
1111110000000000000000011111111110001111111111111111111111111111
1111110000000001000000011111111110001111111111111111111111111111
1111110000000001111111111111111110001111111111111111111111111111
1000110000000001111111111111111110001111111111111111111111111111
1000111111011111111111111111111110001111111111111111111111111111
1000111110001111111111111111111000000011111111111111111111111111
1101111110001111111111111111111110001111111111111111111111111111
1000111110001111111111111111111110001111111111111111111111111111
1000100010001111111111111111111110001111111111111111111111111111
1000000010001111111111111111111110001111111111111111111111111111
1000100010001111111111111111111110001111111111111111111111111111
1000111111011111111111111111111111011111111111111111111111111111
1000110000000001111111111111111100000111111111111111110000000011
1000110000000001111111111110000000000000001111111111110000000011
1000110000000001111111111110000000000000001111111111110000000011
1000010000000001111111111110000000000000000100000000010000000011
1000000000000001111111111110000000000000000000000000000000000011
1000010000000001111111111110000000000000000100000000010000000011
1000110000000001111111111110000000000000001111111111110000000011
1000110000000001111111111110000000000000001111111111110000000011
1000110000000001111111111111111100000111111111111111110000000011
1000111111011111111111111111111111011111111111111111111111111111
1000111110001111111111111111111110001111111111111111111111111111
1000111110001111111111111111111110001111111111111111111111111111
1000100010001111111111111111111110001111111111111111111111111111
1000000010001111111111111111111110001111111111111111111111111111
1000100010001111111111111111111110001111111111111111111111111111
1000111110001111111111111111111110001111111111111111111111111111
1000111110001111111111111111111110001111111111111111111111111111
1000000000000000010000001111111110001111111111111111111111111111
1000000000000000000000000011111110001111111111111111111111111111
1000000000000000010000001111111110001111111111111111111111111111
1111111111111111111111111111111110001111111111111111111111111111
1111111111111111111111111111111112021111111111111111111111111111
1111111111111111111111111111000010001000011111111111111111111111
1111111111111111111111111111000000000000011111111111111111111111
1111111111111111111111111111000010001000011111111111111111111111
1111111111111111111111111111000010001000011111111111111111111111
1111111111111111111111111111111110001111111111111111111111111111
1111111111111111111111111111000010001000011111111111111111111111
1111111111111111111111111111000000000000011111111111111111111111
1111111111111111111111111111000010001000011111111111111111111111
1111111111111111111111111111111110001111111111111111111111111111
1111111111111111111111111111000000000000011111111111111111111111
1111111111111111111111111111000000000000011111111111111111111111
1111111111111111111111111111000000000000011111111111111111111111
1111111111111111111111111111111211211211111111111111111111111111

64x64 Wolfenstein 3D first level layout