[38, 38, 38, 38, 38, 38, 38, 38, 38, 38, 38, 38, 38, 38, 38, 38, 38, 38, 38, 38, 38, 38, 38, 38, 38, 38, 38, 38, 38, 38, 38, 38, 38, 38, 38, 38, 38, 38, 38, 38, 38, 38, 38, 38, 38, 38, 38, 38, 38, 38, 38, 38, 38, 38, 38, 38, 38, 38, 38, 38, 38, 38, 38, 38]
[38, 38, 38, 38, 38, 38, 38, 38, 38, 38, 38, 38, 38, 38, 38, 38, 38, 38, 38, 38, 38, 38, 38, 38, 38, 38, 38, 38, 38, 38, 38, 38, 38, 38, 38, 38, 38, 38, 38, 38, 38, 38, 38, 38, 38, 38, 38, 38, 38, 38, 38, 38, 38, 38, 38, 38, 38, 38, 38, 38, 38, 38, 38, 38]
[38, 38, 38, 38, 38, 38, 38, 38, 38, 38, 38, 38, 38, 38, 38, 38, 38, 38, 38, 38, 38, 38, 38, 38, 38, 38, 38, 38, 38, 38, 38, 38, 38, 38, 38, 38, 38, 38, 38, 38, 38, 38, 38, 38, 38, 38, 38, 38, 38, 38, 38, 38, 38, 38, 38, 38, 38, 38, 38, 38, 38, 38, 38, 38]
[38, 38, 38, 38, 38, 38, 38, 38, 38, 38, 38, 38, 38, 38, 38, 38, 38, 38, 38, 38, 38, 38, 38, 38, 38, 38, 38, 38, 38, 38, 38, 38, 38, 38, 38, 38, 38, 38, 38, 38, 38, 38, 38, 38, 38, 38, 38, 38, 38, 38, 38, 38, 38, 38, 38, 38, 38, 38, 38, 38, 38, 38, 38, 38]
[38, 38, 38, 38, 38, 38, 38, 38, 38, 38, 38, 38, 38, 38, 38, 38, 38, 38, 38, 38, 38, 38, 38, 38, 38, 38, 38, 38, 38, 38, 38, 38, 38, 38, 38, 38, 38, 38, 38, 38, 38, 38, 38, 38, 38, 38, 38, 38, 38, 38, 38, 38, 38, 38, 38, 38, 38, 38, 38, 38, 38, 38, 38, 38]
[38, 38, 38, 38, 38, 38, 38, 38, 38, 38, 38, 38, 38, 38, 38, 38, 38, 38, 38, 38, 38, 38, 38, 38, 38, 38, 38, 38, 38, 38, 38, 38, 38, 38, 38, 38, 38, 38, 38, 38, 38, 38, 38, 43, 43, 43, 43, 43, 43, 43, 43, 43, 43, 43, 43, 38, 38, 38, 38, 38, 38, 38, 38, 38]
[38, 38, 38, 38, 38, 38, 38, 38, 38, 38, 38, 38, 38, 38, 38, 38, 38, 38, 38, 38, 38, 38, 38, 38, 38, 38, 38, 38, 38, 38, 38, 38, 38, 38, 38, 38, 38, 38, 38, 38, 38, 38, 43, 79, 0, -17, 0, -17, 0, -17, 0, 0, 79, 0, -17, 43, 38, 38, 38, 38, 38, 38, 38, 38]
[38, 38, 38, 38, 38, 38, 38, 38, 38, 38, 38, 38, 38, 38, 38, 38, 38, 38, 38, 38, 38, 38, 38, 38, 38, 38, 38, 38, 38, 38, 38, 38, 38, 38, 38, 38, 38, 38, 38, 38, 38, 38, 43, 0, 0, -17, 0, 0, -17, 0, -15, -17, 0, 0, 0, 43, 38, 38, 38, 38, 38, 38, 38, 38]
[38, 38, 38, 38, 38, 38, 38, 38, 38, 38, 38, 38, 38, 38, 38, 38, 38, 38, 38, 38, 38, 38, 38, 38, 38, 38, 38, 38, 38, 38, 38, 38, 38, 38, 38, 38, 38, 38, 38, 38, 38, 38, 43, -17, 0, 43, 43, 43, 43, 43, 43, 43, 43, 0, -17, 43, 38, 38, 38, 38, 38, 38, 38, 38]
[38, 38, 38, 38, 38, 38, 38, 38, 38, 38, 38, 38, 38, 38, 38, 38, 38, 38, 38, 38, 38, 38, 38, 38, 38, 38, 38, 38, 38, 38, 38, 38, 38, 38, 38, 38, 38, 38, 38, 38, 38, 38, 43, 0, -17, 43, 38, 38, 38, 38, 38, 38, 43, -17, 0, 38, 38, 38, 38, 38, 38, 38, 38, 38]
[38, 38, 38, 38, 38, 38, 38, 38, 38, 38, 38, 38, 38, 38, 38, 38, 38, 38, 38, 38, 38, 38, 38, 38, 38, 38, 38, 38, 38, 38, 38, 38, 38, 38, 38, 38, 38, 38, 38, 38, 38, 38, 43, -15, 0, 43, 38, 38, 38, 38, 38, 38, 38, 0, 0, 0, 0, -15, 0, -7, 4, 38, 38, 38]
[38, 38, 38, 38, 38, 38, 38, 38, 38, 38, 38, 38, 38, 38, 38, 38, 38, 38, 38, 38, 38, 38, 38, 38, 38, 38, 38, 38, 38, 38, 38, 38, 44, 44, 44, 38, 38, 38, 38, 38, 38, 38, 43, -17, -15, 43, 43, 43, 38, 38, 38, 38, 38, -17, 0, 0, 82, 0, -15, -7, 3, 38, 38, 38]
[38, 38, 38, 38, 38, 38, 38, 38, 38, 38, 38, 38, 38, 38, 38, 38, 38, 38, 38, 38, 38, 38, 38, 38, 38, 38, 38, 38, 38, 38, 38, 44, -17, -17, -17, 44, 38, 38, 38, 38, 38, 38, 43, 0, -17, 0, -17, 0, 38, 38, 38, 38, 38, 38, 38, 38, 38, 38, 21, 38, 38, 38, 38, 38]
[38, 38, 38, 38, 38, 38, 38, 38, 38, 38, 38, 38, 38, 38, 38, 38, 38, 38, 38, 38, 38, 38, 38, 38, 38, 38, 38, 38, 38, 38, 38, 44, -17, -1, -17, 44, 38, 38, 38, 38, 38, 38, 43, 79, 0, -17, 0, 0, 38, 0, 0, 0, 0, 0, 0, 0, 0, 0, 0, 0, 38, 38, 38, 38]
[38, 38, 38, 38, 38, 38, 38, 38, 38, 38, 38, 38, 38, 38, 38, 38, 38, 38, 38, 38, 38, 38, 38, 38, 38, 38, 38, 38, 38, 38, 38, 44, -17, -17, -17, 44, 38, 38, 38, 38, 38, 38, 38, 43, 43, 43, 0, 0, 38, 0, -21, 0, 79, 0, -21, 0, 79, 0, -21, 0, 38, 38, 38, 38]
[38, 38, 38, 38, 38, 38, 38, 38, 38, 38, 38, 38, 38, 38, 38, 38, 38, 38, 38, 38, 38, 38, 38, 38, 38, 38, 38, 38, 38, 38, 38, 38, 38, 24, 38, 38, 38, 38, 38, 38, 38, 38, 38, 38, 38, 38, 0, 0, 38, 0, 0, 0, 0, 0, 0, 0, 0, 0, 0, 0, 38, 38, 38, 38]
[38, 38, 38, 38, 38, 38, 38, 38, 38, 38, 38, 38, 38, 38, 38, 38, 38, 38, 38, 38, 38, 38, 38, 38, 38, 38, 38, 38, 38, 38, 38, 38, 0, 0, 0, 38, 38, 38, 38, 38, 38, 38, 38, 38, 38, 38, 0, 0, 38, 0, 0, 0, 38, 38, 38, 38, 38, 0, 0, 0, 38, 38, 38, 38]
[38, 38, 38, 38, 38, 38, 38, 38, 38, 38, 38, 38, 38, 38, 38, 38, 38, 38, 38, 38, 38, 38, 38, 38, 38, 38, 38, 38, 38, 38, 38, 0, 0, 79, 0, 0, 38, 0, 0, 0, 0, 0, 38, 0, 0, 79, 0, 0, 44, 0, 0, 0, 38, 38, 38, 38, 38, 0, 0, 0, 38, 38, 38, 38]
[38, 38, 38, 38, 38, 38, 38, 38, 38, 38, 38, 38, 38, 38, 38, 38, 38, 38, 38, 38, 38, 38, 38, 38, 38, 38, 38, 38, 38, 38, 38, 0, 0, -21, 0, 0, 21, 80, 0, -21, 79, -7, 21, 0, 0, -21, 0, 0, 21, 0, -21, 0, 38, 38, -6, 80, 0, 0, -21, 0, 38, 38, 38, 38]
[38, 38, 38, 38, 38, 38, 38, 38, 38, 38, 38, 38, 38, 38, 38, 38, 38, 38, 38, 38, 38, 38, 38, 38, 38, 38, 38, 38, 38, 38, 38, 0, 0, 0, 0, 0, 38, 0, 0, 0, 0, 0, 38, 0, 0, 0, 0, 80, 44, 0, 0, 0, 38, 38, -16, -6, 38, 0, 0, 0, 38, 38, 38, 38]
[38, 38, 38, 38, 38, 38, 38, 38, 38, 38, 38, 38, 38, 38, 38, 38, 38, 38, 38, 38, 38, 38, 38, 38, 38, 38, 38, 38, 38, 38, 38, 38, 0, 0, 0, 38, 38, 38, 38, 38, 38, 38, 38, 38, 38, 38, 38, 38, 38, 38, 21, 38, 38, 38, 38, 38, 38, 0, 0, 0, 38, 38, 38, 38]
[38, 38, 38, 38, 38, 38, 38, 38, 38, 38, 38, 38, 38, 38, 38, 38, 38, 38, 38, 38, 38, 38, 38, 38, 38, 38, 38, 38, 38, 38, 38, 38, 42, 21, 42, 38, 38, 38, 38, 38, 38, 38, 38, 38, 59, 59, 59, 59, 59, 0, 0, 0, 59, 59, 59, 59, 59, 62, 21, 62, 59, 59, 59, 59]
[38, 38, 38, 38, 38, 38, 38, 38, 38, 38, 38, 38, 38, 38, 38, 38, 38, 38, 38, 38, 38, 38, 38, 38, 38, 52, 52, 52, 52, 52, 54, 9, 0, 0, 0, 9, 54, 52, 51, 52, 52, 52, 52, 52, 59, 59, 59, 59, 59, -6, -21, -6, 59, 59, 59, 59, 59, 0, 0, 0, 59, 59, 59, 59]
[38, 38, 38, 38, 38, 38, 38, 38, 38, 38, 38, 38, 38, 38, 38, 38, 38, 38, 38, 38, 38, 38, 38, 38, 38, 52, 52, 51, 2, 0, 0, 0, 0, 0, 0, 0, 0, 0, 2, 52, 52, 52, 51, 52, 59, 59, 59, 59, 59, 2, -6, 2, 59, 59, 59, 59, 59, 0, 0, 0, 59, 59, 59, 59]
[38, 38, 38, 38, 38, 38, 38, 38, 38, 38, 38, 38, 38, 38, 38, 38, 38, 38, 38, 38, 38, 38, 38, 38, 38, 52, 52, 52, 0, 0, 0, 80, 0, 0, 0, 0, 0, 0, 0, 52, 0, 0, 18, 52, 59, 59, 59, 59, 59, 59, 59, 59, 59, 59, 59, 59, 59, 0, -20, 0, 2, 2, 59, 59]
[38, 38, 38, 38, 38, 38, 38, 38, 38, 38, 38, 38, 38, 38, 38, 38, 38, 38, 38, 38, 38, 38, 38, 38, 38, 52, 52, 51, 0, 0, -21, 0, 0, -21, 0, 0, -21, 0, 0, 21, 0, 0, -8, 52, 59, 59, 59, 59, 59, 59, 59, 59, 59, 59, 59, 59, 59, 0, 79, 0, -6, -6, 63, 59]
[38, 38, 38, 38, 38, 38, 38, 38, 38, 38, 38, 38, 38, 38, 38, 38, 38, 38, 38, 38, 38, 38, 38, 38, 38, 52, 52, 52, 0, 0, 0, 0, 0, -4, 0, 0, 0, 0, 0, 52, 0, 0, 0, 51, 59, 59, 59, 59, 59, 59, 60, 59, 60, 59, 60, 59, 59, 0, 0, 0, -6, -6, 63, 59]
[38, 38, 38, 38, 38, 38, 38, 38, 38, 38, 38, 38, 38, 38, 38, 38, 38, 38, 38, 38, 38, 38, 38, 38, 38, 52, 52, 52, 2, 0, 0, 0, 0, -3, 0, 0, 0, 0, 2, 51, 52, 52, 51, 52, 59, 59, 59, 59, 59, 0, 0, 0, 79, 0, 0, 0, 59, 0, -20, 0, 2, 2, 59, 59]
[38, 38, 38, 38, 38, 38, 38, 38, 38, 38, 38, 38, 38, 38, 38, 38, 38, 38, 38, 38, 38, 38, 38, 38, 38, 52, 52, 52, 52, 52, 52, 52, 52, 21, 52, 52, 52, 0, 52, 52, 52, 52, 52, 52, 59, 59, 59, 59, 59, 0, 7, -6, 7, -6, 7, 0, 59, 0, 0, 0, 59, 59, 59, 59]
[38, 38, 38, 38, 38, 38, 38, 38, 38, 38, 38, 38, 38, 38, 38, 38, 38, 38, 38, 38, 38, 38, 38, 38, 38, 52, 0, 0, 0, 0, 0, 71, 0, -1, 0, 52, 0, 0, 0, 51, 52, 52, 52, 52, 59, 59, 59, 59, 59, 0, 7, -6, 7, -6, 7, 79, 59, 0, 0, 0, 59, 59, 59, 59]
[38, 38, 38, 38, 38, 38, 38, 38, 38, 38, 38, 38, 38, 38, 38, 38, 38, 38, 38, 38, 38, 38, 38, 38, 38, 52, 52, 0, 52, 52, 52, 52, 0, 0, 18, 51, 0, -16, 0, 52, 52, 52, 52, 52, 59, 59, 59, 59, 59, 0, 0, 0, 0, 0, 0, 0, 59, 59, 21, 59, 59, 59, 59, 59]
[38, 38, 38, 38, 38, 38, 38, 38, 38, 38, 38, 38, 38, 38, 38, 38, 38, 38, 38, 38, 38, 38, 38, 38, 38, 52, 52, -2, 52, 52, 52, 52, 0, 0, 0, 52, 0, 0, 2, 52, 52, 52, 52, 52, 59, 59, 59, 59, 59, 59, 21, 59, 60, 59, 60, 59, 0, 0, 0, 0, 0, 59, 59, 59]
[38, 38, 38, 38, 38, 38, 38, 38, 38, 38, 38, 38, 38, 38, 38, 38, 38, 38, 38, 38, 38, 38, 38, 38, 38, 59, 59, 59, 62, 61, 62, 59, 52, 52, 52, 52, 52, 51, 51, 52, 52, 52, 52, 52, 59, 59, 59, 59, 59, 0, 0, 0, 59, 59, 59, 0, 0, 0, 0, 0, 0, 0, 59, 59]
[38, 38, 38, 38, 38, 38, 38, 38, 38, 38, 38, 38, 38, 38, 38, 38, 38, 38, 38, 38, 38, 38, 38, 38, 38, 59, 59, 0, 0, 0, 0, 0, 59, 59, 59, 59, 60, 59, 59, 60, 59, 59, 59, 59, 59, 59, 59, 59, 59, 0, -20, 0, 59, 59, 0, -20, 0, 0, 61, 0, 79, -20, 0, 59]
[38, 38, 38, 38, 38, 38, 38, 38, 38, 38, 38, 38, 38, 38, 38, 38, 38, 38, 38, 38, 38, 38, 38, 38, 38, 59, 0, 0, -6, 7, -6, 0, 0, 59, 2, 0, 9, 0, 0, 9, 0, 2, 59, 59, 59, 59, 59, 59, 59, 0, 0, 0, 62, 0, 0, 0, 0, 15, 62, 15, 0, 0, 0, 59]
[38, 38, 38, 38, 38, 38, 38, 38, 38, 38, 38, 38, 38, 38, 38, 38, 38, 38, 38, 38, 38, 38, 38, 38, 38, 62, 0, -6, 0, 79, 0, -6, 0, 59, 0, 0, 0, 0, 0, 0, 0, 0, 59, 0, 0, 0, 0, 0, 79, 0, 0, 0, 24, 0, 79, 0, 61, 62, 62, 62, 61, 0, 0, 23]
[38, 38, 38, 38, 38, 38, 38, 38, 38, 38, 38, 38, 38, 38, 38, 38, 38, 38, 38, 38, 38, 38, 38, 38, 38, 61, 0, 7, 0, -20, 0, 7, 0, 21, 0, 0, -20, 0, 0, -20, 0, 0, 21, 0, -20, 0, 0, -20, 0, 0, -20, 0, 62, 0, 0, 0, 0, 15, 62, 15, 0, 0, 0, 59]
[38, 38, 38, 38, 38, 38, 38, 38, 38, 38, 38, 38, 38, 38, 38, 38, 38, 38, 38, 38, 38, 38, 38, 38, 38, 62, 0, -6, 0, 79, 0, -6, 0, 59, 0, 0, 0, 0, 0, 0, 0, 0, 59, 0, 0, 79, 0, 0, 0, 0, 0, 0, 59, 59, 0, -20, 0, 0, 61, 0, 0, -20, 0, 59]
[38, 38, 38, 38, 38, 38, 38, 38, 38, 38, 38, 38, 38, 38, 38, 38, 38, 38, 38, 38, 38, 38, 38, 38, 38, 59, 0, 0, -6, 7, -6, 0, 0, 59, 2, 0, 0, 0, 0, 0, 0, 2, 59, 59, 59, 0, -20, 0, 59, 59, 59, 59, 59, 59, 59, 0, 0, 0, 0, 0, 0, 0, 59, 59]
[38, 38, 38, 38, 38, 38, 38, 38, 38, 38, 38, 38, 38, 38, 38, 38, 38, 38, 38, 38, 38, 38, 38, 38, 38, 59, 59, 0, 0, 0, 0, 0, 59, 59, 59, 59, 60, 59, 59, 21, 59, 59, 59, 59, 59, 0, 0, 0, 59, 59, 59, 59, 59, 59, 59, 59, 0, 0, 79, 0, 0, 59, 59, 59]
[38, 38, 38, 38, 38, 38, 38, 38, 38, 38, 38, 38, 38, 38, 38, 38, 79, 0, 0, 0, 79, 0, 0, 38, 38, 59, 59, 59, 62, 61, 62, 59, 59, 59, 59, 59, 59, 59, 0, 0, 0, 59, 59, 59, 59, 59, 21, 59, 59, 59, 59, 59, 59, 59, 59, 59, 59, 0, 0, 0, 59, 59, 59, 59]
[59, 59, 62, 59, 59, 59, 59, 59, 59, 59, 59, 59, 38, 38, 38, 38, 0, 0, 0, 0, 47, 47, 0, 38, 38, 40, 43, 38, 38, 38, 38, 45, 45, 38, 59, 63, 14, 79, 0, -20, 0, 0, 14, 63, 59, 0, 0, 0, 59, 26, 26, 26, 26, 26, 27, 26, 26, 26, 21, 26, 26, 26, 26, 26]
[59, 10, 0, 10, 59, 59, 59, 59, 59, 59, 59, 59, 38, 38, 38, 38, 0, 0, 0, 0, 47, 47, 0, 38, 38, 5, 0, 5, 38, 45, -6, 80, -6, 38, 59, 59, 59, 59, 0, 0, 0, 59, 59, 59, 59, 0, -20, 0, 59, 26, 26, 26, 26, 26, 0, 0, 0, 0, 0, 0, 26, 26, 26, 26]
[59, 0, 0, 0, 59, 59, 59, 59, 59, 59, 59, 59, 38, 38, 38, 38, 0, 0, 82, 0, 0, 0, 0, 38, 38, 79, 0, 79, 38, 45, 0, -16, 0, 38, 59, 59, 59, 59, 0, 0, 0, 59, 59, 59, 59, 79, 0, 0, 59, 26, 26, 26, 26, 27, 0, -21, 0, 79, 80, 0, 26, 26, 26, 26]
[59, 0, -20, 0, 59, 63, 59, 63, 59, 63, 59, 63, 38, 38, 38, 38, 0, 47, 47, 0, 0, 0, 0, 38, 38, 0, -21, 0, 38, 38, -6, 0, -6, 45, 59, 63, 14, 0, 0, -20, 0, 79, 14, 63, 59, 0, 0, 0, 59, 26, 26, 26, 26, 26, 0, 0, 0, 0, 0, 0, 26, 26, 26, 26]
[59, 0, 0, 0, 62, 15, 79, 15, 0, 15, 0, 15, 38, 14, 0, 0, 0, 47, 47, 0, 0, 0, 0, 38, 38, 0, 0, 0, 38, 38, 38, 80, 38, 38, 59, 59, 59, 59, 0, 0, 0, 59, 59, 59, 59, 0, -20, 79, 59, 27, -4, 0, 0, 26, 0, 0, 0, 26, 29, 28, 26, 26, 26, 26]
[59, 0, 0, 0, 0, 0, 0, 0, 0, 0, 0, 0, 44, -7, 0, 0, 0, 0, 0, 0, 0, 0, 0, 38, 38, 0, 0, 0, 38, 0, 0, 0, 0, 0, 60, 0, 0, 0, 0, 0, 0, 0, 0, 0, 60, 0, 0, 0, 59, 26, 0, -21, 0, 21, 0, 0, 0, 26, 26, 26, 26, 26, 26, 26]
[59, 0, -20, 0, 0, 0, -20, 0, 0, 0, -20, 0, 21, -7, 0, 0, 0, 0, 0, 47, 47, 0, 0, 38, 38, 0, -21, 0, 21, 0, 0, 79, 0, 0, 21, 79, -20, 0, 0, 61, 0, 0, -20, 79, 21, 79, 0, 0, 59, 26, -5, 0, 0, 26, 0, 0, 0, 26, 0, 13, 0, 26, 26, 26]
[59, 0, 0, 0, 0, 0, 0, 0, 0, 0, 0, 0, 44, -7, 0, 0, 0, 0, 0, 47, 47, 0, 0, 38, 38, 0, 0, 0, 38, 0, 0, 0, 0, 0, 60, 0, 0, 0, 0, 0, 0, 0, 0, 0, 60, 0, -20, 0, 59, 26, 27, 26, 26, 26, 0, -21, 0, 0, 0, 0, 13, 28, 26, 26]
[59, 0, 0, 0, 62, 15, 0, 15, 0, 15, 79, 15, 38, 14, 82, 0, 0, 0, 0, 0, 0, 0, 0, 38, 38, 10, 0, 10, 38, 38, 38, 80, 38, 38, 59, 59, 59, 59, 0, 0, 0, 59, 59, 59, 59, 15, 0, 15, 59, 26, 26, 26, 26, 26, 0, 79, 0, 26, 0, 13, 0, 26, 26, 26]
[59, 0, -20, 0, 59, 63, 59, 63, 59, 63, 59, 63, 38, 38, 38, 38, 38, 38, 0, 0, 0, 79, 0, 38, 38, 40, 21, 38, 38, 38, -6, 0, -6, 45, 59, 59, 59, 59, 0, -20, 0, 59, 59, 59, 59, 59, 62, 59, 59, 26, 26, 26, 26, 29, 0, 0, 0, 26, 26, 27, 26, 26, 26, 26]
[23, 0, 80, 0, 59, 59, 59, 59, 59, 59, 59, 59, 38, 38, 38, 38, 38, 38, 0, 79, 0, 0, 0, 38, 38, 0, 0, 0, 38, 45, 0, -16, 0, 45, 59, 59, 59, 59, 0, 0, 0, 59, 59, 59, 59, 59, 59, 59, 59, 26, 26, 26, 26, 26, 4, 4, 3, 26, 26, 26, 26, 26, 26, 26]
[59, 0, 79, 0, 59, 59, 59, 59, 59, 59, 59, 59, 38, 38, 38, 38, 38, 38, 0, 0, 0, 0, 0, 38, 38, 0, -21, 0, 38, 38, -6, 80, -6, 38, 59, 59, 59, 59, 60, 21, 60, 59, 59, 59, 59, 59, 59, 59, 59, 26, 26, 26, 26, 26, 26, 26, 29, 26, 26, 26, 26, 26, 26, 26]
[59, 62, 22, 62, 59, 59, 59, 59, 59, 59, 59, 59, 38, 38, 38, 38, 38, 38, 38, 44, 21, 44, 38, 38, 38, 0, 0, 0, 38, 38, 45, 38, 45, 38, 38, 38, 52, 52, 0, 0, 0, 52, 52, 52, 51, 52, 52, 52, 52, 26, 26, 26, 26, 26, 26, 26, 26, 26, 26, 26, 26, 26, 26, 26]
[59, 47, 0, 47, 59, 59, 59, 59, 59, 59, 59, 59, 38, 38, 38, 38, 38, 38, 38, 0, 0, 0, 38, 38, 38, 0, 82, 0, 38, 38, 38, 38, 38, 38, 38, 38, 52, 0, 0, 0, 0, 0, 56, 0, -7, 18, 52, 52, 52, 26, 26, 26, 26, 26, 26, 26, 26, 26, 26, 26, 26, 26, 26, 26]
[59, 59, 74, 59, 59, 59, 59, 59, 59, 59, 59, 59, 38, 38, 38, 38, 38, 38, 38, 0, -21, 0, 38, 38, 38, 0, -21, 0, 38, 38, 45, 38, 45, 38, 38, 38, 52, 0, 0, 82, 0, 0, 21, 0, 0, 0, 51, 52, 52, 26, 26, 26, 26, 26, 26, 26, 26, 26, 26, 26, 26, 26, 26, 26]
[59, 59, 59, 59, 59, 59, 59, 59, 59, 59, 59, 59, 38, 38, 38, 38, 38, 38, 38, 0, 0, 0, 38, 38, 38, 0, 0, 0, 38, 38, 3, 38, 4, 38, 38, 38, 52, 0, 0, 0, 0, 0, 56, 0, -7, 19, 51, 52, 52, 26, 26, 26, 26, 26, 26, 26, 26, 26, 26, 26, 26, 26, 26, 26]
[59, 59, 59, 59, 59, 59, 59, 59, 59, 59, 59, 59, 38, 38, 38, 38, 38, 5, 0, 0, 0, 0, 0, 0, 0, 0, 0, 0, 38, 0, -17, 0, -6, -17, 38, 38, 52, 52, 15, 0, 15, 52, 52, 51, 52, 52, 52, 52, 52, 26, 26, 26, 26, 26, 26, 26, 26, 26, 26, 26, 26, 26, 26, 26]
[59, 59, 59, 59, 59, 59, 59, 59, 59, 59, 59, 59, 38, 38, 38, 38, 42, -7, 0, 79, -21, 0, 0, -21, 0, 0, -21, 0, 21, 0, -6, 5, -17, 0, 38, 38, 52, 52, 52, 52, 52, 52, 52, 52, 52, 52, 52, 52, 52, 26, 26, 26, 26, 26, 26, 26, 26, 26, 26, 26, 26, 26, 26, 26]
[59, 59, 59, 59, 59, 59, 59, 59, 59, 59, 59, 59, 38, 38, 38, 38, 38, 5, 0, 0, 0, 0, 0, 0, 0, 0, 0, 0, 38, 0, -17, 0, -6, -17, 38, 38, 52, 52, 52, 52, 52, 52, 52, 52, 52, 52, 52, 52, 52, 26, 26, 26, 26, 26, 26, 26, 26, 26, 26, 26, 26, 26, 26, 26]
[59, 59, 59, 59, 59, 59, 59, 59, 59, 59, 59, 59, 38, 38, 38, 38, 38, 38, 38, 38, 38, 38, 38, 38, 38, 38, 38, 38, 38, 38, 4, 38, 3, 38, 38, 38, 52, 52, 52, 52, 52, 52, 52, 52, 52, 52, 52, 52, 52, 26, 26, 26, 26, 26, 26, 26, 26, 26, 26, 26, 26, 26, 26, 26]
[59, 59, 59, 59, 59, 59, 59, 59, 59, 59, 59, 59, 38, 38, 38, 38, 38, 38, 38, 38, 38, 38, 38, 38, 38, 38, 38, 38, 38, 38, 45, 38, 45, 38, 38, 38, 52, 52, 52, 52, 52, 52, 52, 52, 52, 52, 52, 52, 52, 26, 26, 26, 26, 26, 26, 26, 26, 26, 26, 26, 26, 26, 26, 26]
[59, 59, 59, 59, 59, 59, 59, 59, 59, 59, 59, 59, 38, 38, 38, 38, 38, 38, 38, 38, 38, 38, 38, 38, 38, 38, 38, 38, 38, 38, 38, 38, 38, 38, 38, 38, 52, 52, 52, 52, 52, 52, 52, 52, 52, 52, 52, 52, 52, 26, 26, 26, 26, 26, 26, 26, 26, 26, 26, 26, 26, 26, 26, 26]
[59, 59, 59, 59, 59, 59, 59, 59, 59, 59, 59, 59, 38, 38, 38, 38, 38, 38, 38, 38, 38, 38, 38, 38, 38, 38, 38, 38, 38, 38, 38, 38, 38, 38, 38, 38, 52, 52, 52, 52, 52, 52, 52, 52, 52, 52, 52, 52, 52, 26, 26, 26, 26, 26, 26, 26, 26, 26, 26, 26, 26, 26, 26, 26]
