[40, 40, 40, 40, 40, 40, 40, 40, 40, 40, 40, 40, 40, 40, 40, 40, 40, 40, 40, 40, 40, 40, 40, 40, 40, 40, 40, 40, 48, 48, 48, 48, 48, 48, 48, 48, 48, 48, 48, 48, 48, 48, 48, 48, 48, 48, 48, 48, 48, 48, 48, 48, 48, 48, 48, 48, 48, 48, 48, 48, 48, 48, 48, 48]
[40, 40, 40, 40, 40, 40, 40, 40, 40, 40, 40, 40, 40, 40, 40, 40, 40, 40, 40, 40, 40, 40, 40, 40, 40, 40, 40, 40, 48, 48, 48, 48, 48, 48, 48, 48, 48, 48, 48, 48, 48, 48, 48, 48, 48, 48, 48, 48, 48, 48, 48, 48, 48, 48, 48, 48, 48, 48, 48, 48, 48, 48, 48, 48]
[40, 40, 40, 40, 40, 40, 40, 40, 40, 40, 40, 40, 40, 40, 40, 40, 40, 40, 40, 40, 40, 40, 40, 40, 40, 40, 40, 40, 48, 48, 48, 48, 48, 48, 48, 48, 48, 48, 48, 48, 48, 48, 48, 48, 48, 48, 48, 48, 48, 48, 48, 48, 48, 48, 48, 48, 48, 48, 48, 48, 48, 48, 48, 48]
[40, 40, 40, 40, 40, 40, 40, 40, 40, 40, 40, 40, 40, 40, 40, 40, 40, 40, 40, 40, 40, 40, 40, 40, 40, 40, 40, 40, 48, 48, 48, 48, 48, 48, 48, 48, 48, 48, 48, 48, 48, 48, 48, 48, 48, 48, 48, 48, 48, 48, 48, 48, 48, 48, 48, 48, 48, 48, 48, 48, 48, 48, 48, 48]
[40, 40, 0, 0, 0, 0, 0, 0, 0, 0, 0, 0, 0, 40, 40, 0, 0, 0, 0, 0, 0, 40, 40, 40, 40, 40, 40, 40, 48, 48, 48, 48, 48, 48, 48, 48, 48, 48, 48, 48, 48, 48, 48, 48, 48, 48, 48, 48, 48, 48, 48, 48, 48, 48, 48, 48, 48, 48, 48, 48, 48, 48, 48, 48]
[40, 40, 0, 0, 0, 0, 0, 0, 0, 0, 0, 0, 0, 40, 40, 0, 0, 0, 0, 0, 0, 40, 40, 40, 40, 40, 40, 40, 48, 48, 48, 48, 48, 48, 48, 48, 48, 48, 48, 48, 48, 48, 48, 48, 48, 48, 48, 48, 48, 48, 48, 48, 48, 48, 48, 48, 48, 48, 48, 48, 48, 48, 48, 48]
[40, 40, 0, 0, 0, 30, 0, 0, 0, 30, 0, 0, 0, 40, 40, 0, 0, 0, 0, 0, 0, 21, 0, 0, 0, 40, 40, 40, 48, 48, 48, 48, 48, 48, 48, 48, 48, 48, 48, 48, 48, 48, 48, 48, 48, 48, 48, 48, 48, 48, 48, 48, 48, 48, 48, 48, 48, 48, 48, 48, 48, 48, 48, 48]
[40, 40, 0, 0, 0, 0, 0, 0, 0, 0, 0, 0, 0, 40, 40, 0, 0, 0, 0, 0, 0, 40, 40, 40, 0, 40, 40, 40, 48, 48, 48, 48, 48, 48, 48, 48, 48, 48, 48, 48, 48, 48, 48, 48, 48, 48, 48, 48, 48, 48, 48, 48, 48, 48, 48, 48, 48, 48, 48, 48, 48, 48, 48, 48]
[40, 40, 0, 0, 0, 0, 0, 0, 0, 0, 0, 0, 0, 40, 40, 40, 40, 40, 40, 40, 40, 40, 40, 40, 0, 40, 40, 40, 48, 0, 0, 0, 0, 0, 0, 0, 0, 0, 0, 0, 48, 48, 48, 48, 48, 48, 48, 48, 48, 48, 48, 48, 48, 48, 48, 48, 48, 48, 48, 48, 48, 48, 48, 48]
[40, 40, 40, 40, 40, 40, 40, 40, 40, 40, 40, 21, 40, 40, 40, 40, 40, 40, 40, 40, 40, 40, 40, 40, 21, 40, 40, 40, 48, 0, 0, 73, 0, 0, 0, 0, 0, 0, 0, 0, 48, 48, 48, 48, 48, 48, 48, 48, 48, 48, 48, 48, 48, 48, 48, 48, 48, 48, 48, 48, 48, 48, 48, 48]
[40, 40, 40, 40, 40, 40, 40, 40, 40, 40, 40, 0, 40, 40, 40, 40, 40, 40, 0, 0, 0, 0, 0, 0, 0, 0, 0, 0, 48, 0, 0, 0, 0, 0, 0, 0, 0, 0, 0, 0, 48, 0, 0, 0, 48, 48, 48, 48, 48, 48, 48, 48, 48, 48, 48, 48, 48, 48, 48, 48, 48, 48, 48, 48]
[40, 40, 40, 40, 40, 40, 40, 40, 40, 40, 40, 0, 40, 40, 40, 40, 40, 40, 0, 0, 0, 0, 0, 0, 0, 0, 0, 0, 21, 0, 0, 0, 0, 0, 0, 0, 0, 0, 73, 0, 21, 0, 73, 0, 48, 48, 48, 48, 48, 48, 48, 48, 48, 48, 48, 48, 48, 48, 48, 48, 48, 48, 48, 48]
[40, 40, 40, 40, 40, 40, 40, 40, 40, 40, 40, 0, 40, 40, 40, 40, 40, 40, 0, 0, 0, 0, 0, 0, 0, 0, 0, 0, 48, 0, 0, 0, 0, 0, 0, 0, 0, 0, 0, 0, 48, 0, 0, 0, 48, 48, 48, 48, 48, 48, 48, 48, 48, 48, 48, 48, 48, 48, 48, 48, 48, 48, 48, 48]
[40, 40, 40, 40, 40, 40, 40, 40, 40, 40, 40, 21, 40, 40, 40, 40, 40, 40, 0, 0, 0, 40, 40, 40, 40, 40, 40, 40, 48, 0, 0, 0, 0, 0, 0, 0, 0, 0, 0, 0, 48, 48, 48, 48, 48, 48, 48, 48, 48, 48, 48, 48, 48, 48, 48, 48, 48, 48, 48, 48, 48, 48, 48, 48]
[40, 40, 40, 40, 40, 40, 0, 0, 0, 0, 0, 0, 0, 0, 0, 40, 40, 40, 0, 0, 0, 40, 40, 40, 40, 40, 40, 40, 48, 0, 0, 0, 0, 0, 0, 0, 0, 0, 0, 0, 48, 48, 48, 48, 48, 48, 48, 48, 48, 48, 48, 48, 48, 48, 48, 48, 48, 48, 48, 48, 48, 48, 48, 48]
[40, 40, 40, 40, 40, 40, 0, 0, 0, 0, 0, 73, 0, 0, 0, 40, 40, 40, 0, 73, 0, 40, 40, 40, 40, 40, 40, 40, 48, 48, 48, 48, 48, 48, 21, 48, 48, 48, 48, 48, 48, 48, 48, 48, 48, 48, 48, 48, 48, 48, 48, 48, 48, 48, 48, 48, 48, 48, 48, 48, 48, 48, 48, 48]
[40, 40, 40, 40, 40, 40, 0, 73, 0, 0, 0, 0, 0, 0, 0, 40, 0, 0, 0, 0, 0, 0, 0, 40, 40, 40, 40, 40, 40, 40, 48, 48, 48, 0, 0, 0, 48, 48, 48, 48, 48, 48, 48, 48, 48, 48, 48, 48, 48, 48, 48, 48, 48, 48, 48, 48, 48, 48, 48, 48, 48, 48, 48, 48]
[40, 40, 40, 40, 40, 40, 0, 0, 0, 0, 0, 0, 0, 73, 0, 21, 0, 0, 0, 0, 0, 0, 73, 40, 40, 40, 40, 40, 40, 40, 48, 48, 48, 0, 0, 0, 48, 48, 48, 48, 48, 48, 48, 48, 48, 48, 48, 48, 48, 48, 48, 48, 48, 48, 48, 48, 48, 48, 48, 48, 48, 48, 48, 48]
[40, 40, 40, 40, 40, 40, 0, 0, 0, 0, 0, 0, 0, 0, 0, 40, 0, 0, 0, 0, 0, 0, 0, 40, 40, 40, 40, 40, 40, 40, 48, 48, 48, 0, 0, 0, 48, 48, 48, 48, 48, 48, 48, 48, 48, 48, 48, 48, 48, 48, 48, 48, 48, 48, 48, 48, 48, 48, 48, 48, 48, 48, 48, 48]
[40, 40, 40, 40, 40, 40, 0, 73, 0, 0, 0, 0, 0, 0, 0, 40, 40, 40, 40, 40, 40, 40, 40, 40, 40, 40, 40, 40, 40, 40, 48, 48, 48, 0, 0, 0, 48, 48, 48, 48, 48, 48, 48, 48, 48, 48, 48, 48, 48, 48, 48, 48, 48, 48, 48, 48, 48, 48, 48, 48, 48, 48, 48, 48]
[40, 0, 0, 0, 40, 40, 0, 0, 0, 0, 0, 0, 73, 0, 0, 40, 40, 40, 40, 40, 40, 40, 40, 40, 40, 40, 40, 40, 40, 40, 48, 48, 48, 0, 0, 0, 48, 48, 48, 48, 48, 48, 48, 48, 48, 48, 48, 48, 48, 48, 48, 48, 48, 48, 48, 48, 48, 48, 48, 48, 48, 48, 48, 48]
[40, 0, 0, 0, 40, 40, 40, 40, 40, 40, 21, 40, 40, 40, 40, 40, 40, 40, 40, 40, 40, 40, 40, 40, 40, 40, 40, 40, 40, 40, 48, 48, 48, 0, 73, 0, 48, 48, 48, 48, 48, 48, 48, 48, 48, 48, 48, 48, 48, 48, 48, 48, 48, 48, 48, 48, 48, 48, 48, 48, 48, 48, 48, 48]
[40, 0, 0, 0, 40, 40, 40, 40, 40, 0, 0, 0, 40, 40, 40, 40, 40, 40, 40, 40, 40, 40, 40, 40, 40, 40, 40, 40, 40, 40, 48, 73, 0, 0, 0, 0, 0, 0, 48, 48, 48, 48, 48, 48, 48, 48, 48, 48, 48, 48, 48, 48, 48, 48, 48, 48, 48, 48, 48, 48, 48, 48, 48, 48]
[40, 40, 21, 40, 40, 40, 40, 40, 40, 0, 0, 0, 40, 40, 40, 40, 40, 40, 40, 40, 40, 40, 40, 40, 40, 40, 40, 40, 40, 40, 48, 48, 48, 0, 0, 0, 48, 48, 48, 48, 48, 48, 48, 48, 48, 48, 48, 48, 48, 48, 48, 48, 48, 48, 48, 48, 48, 48, 48, 48, 48, 48, 48, 48]
[40, 0, 0, 0, 40, 40, 40, 40, 40, 0, 0, 0, 40, 40, 40, 40, 40, 40, 40, 40, 40, 40, 40, 40, 40, 40, 40, 40, 40, 40, 40, 48, 48, 0, 0, 0, 48, 48, 48, 48, 48, 48, 48, 48, 48, 48, 48, 48, 48, 48, 48, 48, 48, 48, 48, 48, 48, 48, 48, 48, 48, 48, 48, 48]
[40, 0, 0, 0, 40, 0, 0, 0, 40, 0, 0, 0, 40, 40, 40, 40, 40, 40, 40, 40, 40, 40, 40, 40, 40, 40, 40, 40, 40, 40, 40, 48, 48, 0, 0, 0, 48, 48, 48, 48, 48, 48, 48, 48, 48, 48, 48, 48, 48, 48, 48, 48, 48, 48, 48, 48, 48, 48, 48, 48, 48, 48, 48, 48]
[40, 0, 0, 0, 0, 0, 0, 73, 40, 0, 73, 0, 40, 40, 40, 40, 40, 40, 40, 40, 40, 40, 40, 40, 40, 40, 40, 40, 40, 40, 40, 48, 48, 0, 0, 0, 48, 48, 48, 48, 48, 48, 48, 48, 48, 48, 48, 48, 48, 48, 48, 48, 48, 48, 48, 48, 48, 48, 48, 48, 48, 48, 48, 48]
[40, 0, 0, 0, 40, 0, 0, 0, 40, 0, 0, 0, 40, 40, 40, 40, 40, 40, 40, 40, 40, 40, 40, 40, 40, 40, 40, 40, 40, 40, 40, 48, 48, 0, 0, 0, 48, 48, 48, 48, 48, 48, 48, 48, 48, 48, 48, 48, 48, 48, 48, 48, 48, 48, 48, 48, 48, 48, 48, 48, 48, 48, 48, 48]
[40, 0, 0, 0, 40, 39, 39, 39, 39, 39, 21, 39, 39, 39, 39, 39, 40, 40, 40, 40, 40, 40, 40, 40, 40, 40, 40, 40, 40, 40, 40, 48, 48, 51, 21, 51, 48, 48, 48, 48, 48, 48, 48, 48, 48, 48, 48, 48, 48, 48, 48, 48, 48, 29, 29, 29, 29, 29, 29, 29, 29, 29, 29, 29]
[40, 0, 0, 0, 40, 39, 0, 0, 0, 0, 0, 0, 0, 0, 0, 39, 40, 40, 40, 40, 40, 40, 40, 40, 40, 40, 36, 36, 36, 36, 36, 36, 9, 0, 0, 0, 9, 36, 36, 36, 36, 36, 36, 48, 48, 48, 48, 48, 48, 48, 48, 48, 48, 29, 0, 0, 0, 0, 0, 0, 0, 0, 29, 29]
[40, 0, 0, 0, 40, 39, 0, 0, 0, 0, 0, 0, 0, 0, 0, 39, 40, 40, 40, 40, 40, 40, 40, 40, 40, 40, 36, 0, 0, 73, 0, 0, 0, 0, 0, 0, 0, 0, 0, 0, 0, 0, 36, 48, 48, 48, 48, 48, 48, 48, 48, 48, 48, 29, 0, 0, 0, 73, 0, 0, 0, 0, 29, 29]
[40, 0, 0, 0, 40, 39, 0, 0, 0, 0, 0, 0, 0, 0, 0, 39, 40, 40, 40, 40, 40, 40, 40, 40, 40, 40, 36, 0, 0, 0, 0, 0, 0, 0, 0, 0, 0, 0, 0, 0, 0, 0, 36, 29, 29, 29, 29, 29, 29, 29, 29, 29, 29, 29, 0, 0, 0, 0, 0, 0, 0, 0, 29, 29]
[40, 0, 0, 0, 0, 39, 0, 0, 0, 0, 0, 0, 0, 0, 0, 39, 40, 40, 40, 40, 40, 40, 40, 40, 40, 40, 36, 0, 0, 0, 0, 0, 0, 0, 0, 0, 0, 0, 0, 0, 0, 0, 0, 29, 0, 0, 0, 0, 0, 0, 0, 0, 0, 29, 0, 0, 0, 0, 0, 0, 0, 0, 29, 29]
[40, 0, 0, 0, 0, 21, 0, 0, 0, 0, 0, 0, 0, 0, 0, 39, 40, 40, 0, 21, 0, 21, 0, 0, 21, 0, 0, 0, 0, 0, 0, 0, 0, 0, 0, 0, 0, 0, 0, 0, 73, 0, 0, 21, 0, 0, 0, 0, 0, 0, 0, 0, 0, 21, 0, 0, 0, 0, 0, 0, 0, 0, 29, 29]
[40, 0, 0, 0, 0, 39, 0, 73, 0, 0, 0, 0, 0, 0, 0, 39, 40, 40, 40, 40, 40, 40, 40, 40, 40, 40, 36, 0, 0, 0, 0, 0, 0, 0, 0, 0, 0, 0, 0, 0, 0, 0, 0, 29, 0, 0, 0, 0, 0, 0, 0, 0, 0, 29, 0, 0, 0, 0, 0, 0, 0, 0, 29, 29]
[40, 0, 0, 0, 40, 39, 0, 0, 0, 0, 0, 0, 0, 0, 0, 39, 40, 40, 40, 40, 40, 40, 40, 40, 40, 40, 36, 0, 0, 0, 0, 0, 0, 0, 0, 0, 0, 0, 0, 0, 0, 0, 36, 29, 29, 29, 0, 0, 0, 0, 29, 29, 29, 29, 0, 0, 0, 73, 0, 0, 0, 0, 29, 29]
[40, 0, 0, 0, 40, 39, 0, 0, 0, 0, 0, 0, 0, 0, 0, 39, 40, 40, 40, 40, 40, 40, 40, 40, 40, 40, 36, 0, 0, 0, 0, 0, 0, 0, 0, 0, 0, 0, 0, 0, 0, 0, 36, 29, 29, 29, 29, 0, 0, 29, 29, 29, 29, 29, 0, 0, 0, 0, 0, 0, 0, 0, 29, 29]
[40, 0, 0, 0, 40, 39, 0, 0, 0, 0, 0, 0, 73, 0, 0, 39, 40, 40, 40, 40, 40, 40, 40, 40, 40, 40, 36, 36, 36, 36, 36, 36, 0, 0, 0, 0, 0, 36, 36, 36, 36, 36, 36, 29, 29, 29, 29, 0, 0, 29, 29, 29, 29, 29, 0, 0, 0, 0, 0, 0, 0, 0, 29, 29]
[40, 0, 0, 0, 40, 39, 39, 39, 39, 39, 21, 39, 39, 39, 39, 39, 40, 40, 40, 40, 40, 40, 40, 40, 40, 40, 40, 40, 40, 40, 40, 40, 29, 29, 21, 29, 29, 29, 29, 29, 29, 29, 29, 29, 29, 29, 29, 0, 0, 29, 29, 29, 29, 29, 29, 29, 29, 29, 29, 29, 29, 29, 29, 29]
[40, 0, 0, 0, 40, 40, 40, 40, 40, 0, 0, 0, 40, 40, 40, 40, 40, 40, 40, 40, 40, 40, 40, 40, 40, 40, 40, 40, 40, 40, 40, 40, 29, 0, 0, 0, 29, 29, 29, 29, 29, 29, 29, 29, 29, 29, 29, 0, 0, 29, 29, 29, 29, 29, 29, 29, 29, 29, 29, 29, 29, 29, 29, 29]
[40, 0, 0, 0, 40, 40, 40, 40, 40, 0, 0, 0, 40, 40, 40, 40, 40, 40, 40, 40, 40, 40, 40, 40, 40, 40, 40, 40, 40, 40, 40, 40, 29, 0, 0, 0, 29, 29, 29, 29, 29, 29, 29, 29, 29, 29, 29, 73, 0, 29, 29, 29, 29, 29, 29, 29, 29, 29, 29, 29, 29, 29, 29, 29]
[40, 0, 0, 0, 40, 0, 0, 0, 40, 0, 0, 0, 40, 40, 40, 40, 40, 40, 40, 40, 40, 40, 40, 40, 40, 40, 40, 40, 40, 40, 40, 40, 29, 0, 0, 0, 29, 29, 29, 29, 29, 29, 29, 29, 29, 29, 29, 0, 0, 29, 29, 29, 29, 29, 29, 29, 29, 29, 29, 29, 29, 29, 29, 29]
[40, 0, 0, 0, 0, 0, 0, 0, 40, 0, 0, 0, 40, 40, 40, 40, 40, 40, 40, 40, 40, 40, 40, 40, 40, 40, 40, 40, 40, 40, 40, 40, 29, 0, 0, 0, 29, 29, 29, 29, 29, 29, 29, 29, 29, 29, 29, 0, 0, 29, 29, 29, 0, 29, 0, 29, 0, 29, 0, 29, 29, 29, 29, 29]
[40, 0, 73, 0, 40, 0, 0, 0, 40, 0, 0, 0, 40, 40, 40, 40, 40, 40, 40, 40, 40, 40, 40, 40, 40, 40, 40, 40, 40, 40, 40, 40, 29, 0, 0, 0, 29, 29, 29, 29, 29, 29, 29, 29, 29, 29, 29, 0, 73, 0, 29, 0, 0, 0, 0, 0, 0, 0, 0, 0, 29, 29, 29, 29]
[40, 0, 0, 0, 40, 40, 40, 40, 40, 0, 0, 0, 40, 40, 40, 40, 40, 40, 40, 40, 40, 40, 40, 40, 40, 40, 40, 40, 40, 40, 40, 40, 29, 0, 0, 0, 29, 29, 29, 29, 29, 29, 29, 29, 29, 29, 29, 0, 0, 0, 21, 0, 0, 0, 0, 0, 0, 0, 0, 0, 29, 29, 29, 29]
[40, 0, 0, 0, 40, 40, 40, 40, 40, 0, 73, 0, 40, 40, 40, 40, 40, 40, 40, 40, 40, 40, 40, 40, 40, 40, 40, 40, 40, 40, 40, 40, 29, 0, 0, 0, 29, 29, 29, 29, 29, 29, 29, 29, 29, 29, 29, 0, 0, 0, 29, 0, 0, 0, 0, 0, 0, 0, 0, 0, 29, 29, 29, 29]
[40, 0, 0, 0, 0, 0, 0, 0, 0, 0, 0, 0, 0, 0, 0, 0, 0, 40, 0, 0, 0, 0, 0, 73, 40, 34, 40, 40, 40, 40, 40, 40, 29, 0, 0, 0, 29, 29, 29, 29, 29, 29, 29, 29, 29, 29, 29, 29, 29, 29, 29, 29, 0, 29, 0, 29, 0, 29, 0, 29, 29, 29, 29, 29]
[40, 0, 0, 0, 0, 0, 0, 0, 0, 0, 0, 0, 0, 0, 0, 0, 0, 21, 0, 0, 0, 73, 0, 0, 22, 0, 67, 40, 40, 40, 40, 40, 29, 0, 0, 0, 29, 29, 29, 29, 29, 29, 29, 29, 29, 29, 29, 29, 29, 29, 29, 29, 29, 29, 29, 29, 29, 29, 29, 29, 29, 29, 29, 29]
[40, 0, 0, 0, 0, 0, 0, 0, 0, 0, 0, 0, 0, 0, 0, 0, 0, 40, 0, 0, 0, 0, 0, 73, 40, 34, 40, 40, 40, 40, 40, 40, 29, 0, 0, 0, 29, 29, 29, 29, 29, 29, 29, 29, 29, 29, 29, 29, 29, 29, 29, 29, 29, 29, 29, 29, 29, 29, 29, 29, 29, 29, 29, 29]
[40, 40, 40, 40, 40, 40, 40, 40, 40, 40, 40, 40, 40, 40, 40, 40, 40, 40, 40, 40, 40, 40, 40, 40, 40, 40, 40, 40, 40, 40, 40, 40, 29, 0, 0, 0, 29, 29, 29, 29, 29, 29, 29, 29, 29, 29, 29, 29, 29, 29, 29, 29, 29, 29, 29, 29, 29, 29, 29, 29, 29, 29, 29, 29]
[40, 40, 40, 40, 40, 40, 40, 40, 40, 40, 40, 40, 40, 40, 40, 40, 40, 40, 40, 40, 1, 40, 40, 40, 40, 40, 40, 29, 29, 21, 26, 29, 29, 28, 21, 27, 29, 29, 29, 29, 29, 29, 29, 29, 29, 29, 29, 29, 29, 29, 29, 29, 29, 29, 29, 29, 29, 29, 29, 29, 29, 29, 29, 29]
[40, 40, 40, 40, 40, 40, 40, 40, 40, 40, 40, 40, 40, 40, 40, 40, 40, 40, 40, 40, 21, 40, 40, 40, 40, 40, 40, 29, 0, 0, 0, 0, 29, 0, 0, 0, 29, 1, 0, 0, 1, 29, 29, 29, 29, 29, 29, 29, 29, 29, 29, 29, 29, 29, 29, 29, 29, 29, 29, 29, 29, 29, 29, 29]
[40, 40, 40, 40, 40, 40, 40, 40, 40, 40, 40, 40, 0, 0, 0, 0, 0, 0, 0, 0, 0, 0, 0, 0, 0, 0, 0, 26, 0, 0, 0, 0, 21, 0, 0, 0, 21, 0, 0, 0, 0, 29, 29, 29, 29, 29, 29, 29, 29, 29, 29, 29, 29, 29, 29, 29, 29, 29, 29, 29, 29, 29, 29, 29]
[40, 40, 40, 40, 40, 40, 40, 40, 40, 40, 40, 40, 0, 0, 0, 0, 0, 0, 0, 0, 0, 0, 0, 0, 0, 0, 0, 21, 0, 0, 0, 0, 29, 0, 0, 0, 26, 0, 0, 0, 0, 29, 29, 29, 29, 29, 29, 29, 29, 29, 29, 29, 29, 29, 29, 29, 29, 29, 29, 29, 29, 29, 29, 29]
[40, 40, 40, 40, 40, 40, 40, 40, 40, 40, 40, 40, 0, 0, 0, 0, 0, 0, 0, 0, 0, 0, 0, 0, 0, 0, 0, 29, 0, 0, 0, 0, 29, 0, -3, 0, 26, 1, 0, 0, 1, 29, 29, 29, 29, 29, 29, 29, 0, 0, 0, 29, 29, 29, 29, 29, 29, 29, 29, 29, 29, 29, 29, 29]
[40, 40, 40, 40, 40, 40, 40, 40, 40, 40, 40, 40, 40, 40, 40, 40, 40, 40, 40, 40, 40, 40, 40, 40, 40, 40, 40, 29, 28, 29, 28, 29, 29, 0, -4, -6, 26, 29, 29, 29, 29, 29, 29, 29, 29, 29, 29, 0, 0, 29, 0, 29, 29, 29, 29, 0, 0, 0, 0, 0, 0, 0, 0, 29]
[40, 40, 40, 40, 40, 40, 40, 40, 40, 40, 40, 40, 40, 40, 40, 40, 40, 40, 40, 40, 40, 40, 40, 40, 40, 40, 40, 29, 0, 0, 0, 0, 29, 0, -5, -2, 29, 0, 0, 0, 0, 29, 29, 29, 29, 29, 0, 0, 29, 29, 0, 29, 29, 29, 29, 0, 0, 0, 0, 0, 0, 0, 0, 29]
[40, 40, 40, 40, 40, 40, 40, 40, 40, 40, 40, 40, 40, 40, 40, 40, 40, 40, 40, 40, 40, 40, 40, 40, 40, 40, 40, 27, 0, 0, 0, 0, 21, 0, -1, -2, 21, 0, 0, 49, 0, 29, 29, 29, 29, 29, 0, 29, 29, 29, 0, 0, 0, 0, 0, 0, 0, 0, 0, 0, 0, 0, 0, 29]
[40, 40, 40, 40, 40, 40, 40, 40, 40, 40, 40, 40, 40, 40, 40, 40, 40, 40, 40, 40, 40, 40, 40, 40, 40, 40, 40, 27, 0, 0, 0, 0, 29, 0, -1, 0, 29, 0, 0, 0, 0, 29, 29, 29, 29, 29, 0, 29, 29, 29, 29, 29, 29, 29, 29, 0, 0, 0, 0, 0, 0, 0, 0, 29]
[40, 40, 40, 40, 40, 40, 40, 40, 40, 40, 40, 40, 40, 40, 40, 40, 40, 40, 40, 40, 40, 40, 40, 40, 40, 40, 40, 29, 29, 29, 26, 29, 29, 0, -1, 0, 27, 26, 29, 26, 26, 29, 29, 29, 29, 29, 0, 0, 0, 29, 29, 29, 29, 29, 29, 0, 0, 0, 0, 0, 0, 0, 0, 29]
[40, 40, 40, 40, 40, 40, 40, 40, 40, 40, 40, 40, 40, 40, 40, 40, 40, 40, 40, 40, 40, 40, 40, 40, 40, 40, 40, 29, 0, 0, 0, 0, 0, 0, -1, 0, 0, 0, 0, 0, 0, 29, 0, 29, 29, 29, 29, 29, 0, 29, 29, 29, 29, 29, 29, 0, 0, 0, 0, 0, 0, 0, 0, 29]
[40, 40, 40, 40, 40, 40, 40, 40, 40, 40, 40, 40, 40, 40, 40, 40, 40, 40, 40, 40, 40, 40, 40, 40, 40, 40, 40, 26, 0, 0, 0, 0, 0, 0, 0, 0, 0, 0, 0, 0, 0, 21, 0, 0, 0, 0, 0, 0, 0, 29, 29, 29, 29, 29, 29, 0, 0, 0, 0, 0, 0, 0, 0, 29]
[40, 40, 40, 40, 40, 40, 40, 40, 40, 40, 40, 40, 40, 40, 40, 40, 40, 40, 40, 40, 40, 40, 40, 40, 40, 40, 40, 26, 69, 0, 0, 0, 0, 0, 0, 0, 0, 0, 0, 0, 0, 29, 0, 29, 29, 29, 29, 29, 29, 29, 29, 29, 29, 29, 29, 0, 0, 0, 0, 0, 0, 0, 0, 29]
[40, 40, 40, 40, 40, 40, 40, 40, 40, 40, 40, 40, 40, 40, 40, 40, 40, 40, 40, 40, 40, 40, 40, 40, 40, 40, 40, 29, 27, 26, 29, 29, 26, 29, 27, 29, 29, 28, 29, 29, 29, 29, 29, 29, 29, 29, 29, 29, 29, 29, 29, 29, 29, 29, 29, 29, 29, 29, 29, 29, 29, 29, 29, 29]
